2
120 A -cut-> cA
120 cA -pod-> pA
10 10
**********
*........*
**c*...*d*
*........*
A........$
*........*
*........*
*..   ...*
*........*
**********
2
3 3 
6 6
