2
3 3 
6 6
10 10
**********
*........*
****...***
*........*
*........*
*........*
*........*
*..   ...*
*........*
**********
